1111111111111111111111
10C0000P000000000000E1
1000000000000000000001
10000C00000000C0C00001
1000000000000000000001
1000000000000000000001
1000C0000C000000000001
1000000000000000000001
1111111111111111111111