1111111111111111111111
1000000P000000000000E1
1000000000000000000001
10010C10100101C0C10001
1000001000100010000001
1000000000000100000001
1000000000000100000001
1000000000000100000001
1111111111111111111111