111111111
100P000E1
1C0000001
111111111