1111111111111111111111111
1000000000P00000000000001
1011111111101111110111101
1010001000101000100101001
1000100C10100010101101011
11111111101111101C0C01001
1000000000100000111011101
1011111111101111100010001
1000001C0010001C001110111
111110101011111011000C001
1000001010100000100111111
1011111010101001100011111
10000C00100010C100100C0E1
1111111111111111111111111